ARE	AA R
ARE(2)	ER
CHINESE	CH AY N IY Z
EXIT	EH G Z IH T
EXIT(2)	EH K S AH T
FINE	F AY N
HOW	HH AW
MODE	M OW D
NAME	N EY M
OLD	OW L D
PORT	P AO R T
SERIAL	S IH R IY AH L
THE	DH AH
THE(2)	DH IY
TIME	T AY M
WHAT'S	W AH T S
WHAT'S(2)	HH W AH T S
WRITE	R AY T
YOU	Y UW
YOUR	Y AO R
YOUR(2)	Y UH R
